1 1 1 1 1 1 1 1 1 1 1 1 1 1 1 1 1 1 1 1 1 1 1 1 1
1 0 0 0 2 0 0 0 0 0 2 0 0 0 2 0 0 0 1 0 0 0 0 0 1
1 0 1 2 1 2 1 0 1 2 0 2 1 0 1 0 0 0 2 0 1 2 1 2 1
1 2 2 0 0 0 2 0 2 0 0 0 1 0 0 2 0 0 2 0 2 0 0 0 1
1 0 2 0 0 2 1 0 1 0 0 0 1 0 1 2 1 2 1 0 1 0 2 0 1
1 0 2 0 0 2 0 0 0 0 1 0 2 0 2 0 1 0 1 0 2 2 1 0 1
1 0 1 2 0 2 1 0 1 0 2 0 1 0 1 0 1 0 1 0 1 0 1 0 1
1 0 0 1 2 0 0 0 2 0 0 0 2 1 2 0 1 0 0 2 0 0 2 0 1
1 0 1 2 0 2 1 0 1 0 1 0 1 0 1 0 1 0 0 0 2 0 1 2 1
1 0 2 0 0 0 2 0 0 0 1 0 2 0 0 0 2 0 0 2 0 0 0 0 1
1 0 1 1 0 0 1 0 1 0 1 0 1 0 1 0 1 2 1 0 1 0 0 0 1
1 0 2 2 0 0 2 0 2 0 1 0 2 1 0 0 0 2 0 2 0 2 0 2 1
1 0 1 2 1 2 1 0 1 0 2 0 1 0 1 0 0 0 1 0 1 1 2 1 1
1 2 2 0 2 0 0 0 2 0 2 0 0 2 0 0 0 0 2 0 2 0 0 2 1
1 1 1 1 1 1 1 1 1 1 1 1 1 1 1 1 1 1 1 1 1 1 1 1 1




Tiles:

0 - Grass
1 - Wall
2 - Brick
Portal (18,13)

Character:
Oneal 
Balloon 
Doria
Doll
Minvo

Items:
Flame item (3,8) (8,11) (19,9) (4,1) (9,2) (10,12)
Speed item (4,13) (13,13) (12,5) (18,3) (28,2) (2,9)
Slow item  (6,9) (9,13) (12,9) (16,9)
Wallpass item (14,1) (10,1)





