1 1 1 1 1 1 1 1 1 1 1 1 1 1 1 1 1 1 1 1 1 1 1 1 1
1 0 2 0 2 1 0 1 0 2 0 2 0 2 0 2 0 0 0 2 0 2 0 0 1
1 0 0 1 0 1 0 1 0 1 0 1 0 1 0 1 0 1 2 1 0 1 2 0 1
1 0 0 1 0 2 0 2 0 1 0 2 0 1 0 1 0 2 0 2 0 2 0 0 1
1 0 0 1 0 1 0 1 0 2 0 1 0 1 0 1 0 1 2 1 0 1 2 0 1
1 0 0 1 0 2 0 1 0 1 0 2 0 1 0 1 0 2 0 2 0 2 0 0 1
1 0 0 0 2 1 0 1 0 1 0 1 0 1 0 1 0 1 2 1 2 1 2 0 1
1 2 0 2 0 0 0 1 0 2 0 0 0 2 0 2 0 2 0 2 0 2 0 0 1
1 0 0 0 2 1 0 1 0 1 0 1 0 1 0 1 0 1 2 1 2 1 2 0 1
1 0 0 1 0 2 0 1 0 1 0 2 0 1 0 1 0 2 0 2 0 2 0 0 1
1 0 0 1 0 1 0 1 0 2 0 1 0 1 0 1 0 1 2 1 0 1 2 0 1
1 0 0 1 0 2 0 2 0 1 0 2 0 1 0 1 0 2 0 2 0 2 0 0 1
1 0 0 1 0 1 0 1 0 1 0 1 0 1 0 1 0 1 2 1 0 1 2 0 1
1 0 2 0 2 1 0 1 0 2 0 2 0 2 0 0 0 0 0 2 0 2 0 0 1
1 1 1 1 1 1 1 1 1 1 1 1 1 1 1 1 1 1 1 1 1 1 1 1 1



Tiles:

0 - Grass
1 - Wall
2 - Brick
Portal (23,13)

Character:
Oneal (4,2) (14,1) 
Balloon (4,12)
Doria (1,13) (22,13)
Doll  (8,13)
Minvo (8,1)

Items:
Flame item (2,1) (4,1) (2,13) (4,13) (15,7) (21,7)
Speed item (1,7) (9,13) (10,7) (11,1) (19,3) (20,12)
Slow item  (13,7) (13,1) (13,13) (19,9)
Wallpass item (4,7) (12,3)
Flame pass (12,7) (12,11)